####################
#..................#
#..###........###..#
#....#..........#..#
#....#........###..#
#..................#
#..........#.......#
#..........#.......#
#..........#.......#
#...###............#
#..................#
#............####..#
#........@.........#
#..................#
