####################
#..................#
#..###........###..#
#....#..........#..#
#....#..........#..#
#.............###..#
#..........#.......#
#..........#.......#
#..........#.......#
#...###............#
#..................#
#............####..#
#........@.........#
#..................#
