####################
#..................#
#..###........###..#
#....#..........#..#
#....#..........#..#
#.............###..#
#..@.......#.......#
#..........#.......#
#..........#.......#
#...###.........!..#
#..................#
#............####..#
#..................#
#..................#
