####################
#..................#
#..........@.......#
#...####...........#
#..................#
#...!...........#..#
#..................#
#..................#
#....###...........#
#...............!..#
#...#..............#
#...###......!.....#
#..................#
#..................#