####################
#..................#
#..###........###..#
#....#..........#..#
#....#..........#..#
#.............###..#
#..@.......#.......#
#..........#.......#
#..........#.......#
#...............!..#
#..................#
#....!.............#
#............###...#
#..................#