####################
#..................#
#..###.....@..###..#
#....#..........#..#
#....#..........#..#
#....#.....######..#
#....#.....#.......#
#....#.....#.......#
#....#.....#.......#
#...............!..#
#..................#
####.....!.........#
#..................#
#..................#